%%%%%%%%%%%%%%%%%%%%%
%P.....%........%...%
%.%%%%.%.%%%%%%.%.%.%
%.%....%.%....%.%.%.%
%.%.%%%%.%.%%.%.%.%.%
%...%......%..%...%.%
%%%.%.%%%%%%%.%.%%%.%
%o..%.%.....%.%...o.%
%.%%%.%.%%%.%.%%%%%.%
%.....G...%G......G.%
%%%%%%%%%%%%%%%%%%%%%
