%%%%%%%%%
%P..%...%
%.%.%.%.%
%.%...%.%
%.%%%.%.%
%.....%.%
%%%%%%%%%
