%%%%%
%P..%
%.%.%
%...%
%%%%%
